EA img/gitano.xpm
 WE img/marco.xpm




 
   C 255,255,0
       SO                     img/marcom.xpm
     NO img/gitano.xpm

F 220,100,0

111111111111111111111111111111111111111111111111111111111111111111
1                       100000000001     1000000000000000000000001
1                      100000000001      1000000000111000000000001
1                     100000000001       1000000001  1000000000001
1                    100000000001        100000001   1000000000001
1                   100000000001         10000001    1000000000001
1                  100000000001          1000001     1000000000001
1                 100000000001           100001      1000000000001
1                100000000001            10001       1000000000001
1               100000000001             1001        1000000000001
1              100000000001              101         1000000000001
1             100000000001                1          1000000000001
1            100000000001                            1000000000001
1           100000000001                             1000000000001
1          100000000001                             1000000000001
1         100000000001                             1000000000001
1        100000000001                             1000000000001
1       100000000001                             1000000000001
1      100000000001                             1000000000001
1     100000000001                             1000000000001
1    100000000001                             1000000000001
1   100000000001                             1000000000001
1  100000000001                             1000000000001
1 100000000001                             1000000000001
1100000000001                             1000000000001
100000000001111111111111111111111111     1000000000001
1000000000000000000000000000000000001    1000000000001          1
1000000000000000000000000000000000001    1000000000001         101
1000000000000000000000000000000000001    1000000000001        1001
1000000000000000000000000000000000001    1000000000001       10001
1000000000000000000000000000000000001    1000000000001      100001
1000000000000000000000000000000000001    1000000000001     1000001
1000000000000000000000000000000000001    1000000000001    10000001
1000000000000000000000000000000000001    1000000000001   100000001
1S0000000000000000000000000000000000111111000000000001  1000000001
111111111111111111111111110000000000000000000000000001110000000001
1                        10000000000111111000000000000000000000001
1                        100000000001     11111111111111111111111
1                        100000000001
1                        100000000001
1                        100000000001
1                        100000000001
1                        100000000001
1                        100000000001
1                        100000000001
1                        100000000001
1                        100000000001
1111111111111111111111111111111111111