EA img/marco.xpm
 WE img/gitano.xpm




 
   C 255,255,0
       SO                     img/marcom.xpm
     NO img/rybery.xpm

F 220,100,0

111111111111111111                11111111111111111111111111111111111111111111111111111
100000000000000001                10000000000000000000000000000000000000000000000000001
100000000000000001                10000000000000000000000000000000001100000000000000001
100000000000000001                10000000000000011111100000000000001100000000000000001
10000000S000000001                10000000000011111111111100000000001100000000000000001
100000000000000001                10000000000111111111111110000000001100000000000000001
100000000000000001                10000000000111111111111110000000001100000000000000001
100000000000000001                10000000000111111111111110000000001100000000000000001
100000000000000001                10000000000111111111111110000000001100000000000000001
100000000000000001                10000000000111111111111110000000001100000000000000001
100000000000000001                10000000000111111111111110000000001100000000000000001
100000000000000001                10000000000111111111111110000000001100000000000000001
100000000000000001                10000000000111111111111110000000001100000000000000001
100000000000000001                10000000000111111111111110000000001100000000000000001
100000000000000001                10000000000111111111111110000000001100000000000000001
100000000000000001                10000000000111111111111110000000001100000000000000001
100000000000000001                10000000000111111111111110000000001100000000000000001
100000000000000001                10000000000111111111111110000000001100000000000000001
100000000000000001                10000000000111111111111110000000001100000000000000001
100000000000000001                10000000000111111111111110000000001100000000000000001
100000000000000001                10000000000111111111111110000000001100000000000000001
100000000000000001                10000000000111111111111110000000001100000000000000001
100000000000000001                10000000000111111111111110000000001100000000000000001
100000000000000001                10000000000111111111111110000000001100000000000000001
100000000000000001                10000000000111111111111110000000001100000000000000001
100000000000000001                10000000000111111111111110000000001100000000000000001
100000000000000001                10000000000111111111111110000000001100000000000000001
10000000000000000111111111111111111000000000000111111111100000000000110000000000000000111111111111111111
10000000000000000000000000000000000000000000000000111110000000000000110000000000000000000000000000000001
10000000000000000000000000000000001000000000000000000000000000000000110000000000000000000000000000000001
10000000000000000000000000000000001000000000000000000000000000000000110000000000000000000000000000000001
10000000000000000000000000000000001000000000000000000000000000000000110000000000000000000000000000000001
10000000000000000000000000000000001000000000000000000000000000000000110000000000000000000000000000000001
10000000000000000000000000000000001000000000000000000000000000000000000000000000000000000000000000000001
11111111111111111111111111111111111111111111111111111111111111111111111111111111111111111111111111111111