EA textures/bob.xpm
 WE textures/patrick2.xpm
   C 170,210,230
       SO textures/shreck_chad_1.xpm
     NO textures/zemmour.xpm

F 100,100,110

1111111111111111
10000000000001001
11010010001000001
10001000000001001
10000000010010001
10010000000000001
10000000000000001
10001000100000001
1000000000000000
10100000010000001
100010N0000000001
10000000000000001
10010000001000101
10000010001010001
10000000000001001
1111111111111111
