EA img/gitano.xpm
 WE img/marco.xpm
   C 170,210,230
       SO img/marcom.xpm
     NO img/gitano.xpm

F 100,100,110

11111111111111111
10000000000001001
11010010001000001
10001000000001001
10000000010010001
10010000000000001
10000000000000001
10001000100000001
10000000000000001
10100000010000001
100010N0000000001
10000000000000001
10010000001000101
10000010001010001
10000000000001001
11111111111111111
